dist_num,dist_name,offense,felony,misdemeanor,other,total
1,Central,AGGRAVATED ASSAULT (INDEX),2,6,0,8
1,Central,AGGRAVATED BATTERY (INDEX),4,0,0,4
1,Central,BURGLARY (INDEX),10,0,0,10
1,Central,CRIMINAL SEXUAL ASSAULT (INDEX),1,0,0,1
1,Central,DISORDERLY CONDUCT,2,24,6,32
1,Central,DRIVING UNDER THE INFLUENCE,0,0,0,0
1,Central,DRUG ABUSE VIOLATIONS,2,15,0,17
1,Central,FORGERY AND COUNTERFEITING,0,0,0,0
1,Central,FRAUD,0,0,0,0
1,Central,GAMBLING,0,0,0,0
1,Central,HOMICIDE - 1ST OR 2ND DEGREE (INDEX),1,0,0,1
1,Central,LARCENY - THEFT (INDEX),12,172,0,184
1,Central,LIQUOR LAWS,0,0,0,0
1,Central,MISCELLANEOUS MUNICIPAL CODE VIOLATIONS,0,0,2,2
1,Central,MISCELLANEOUS NON-INDEX OFFENSES,0,42,0,42
1,Central,MOTOR VEHICLE THEFT (INDEX),4,1,0,5
1,Central,OFFENSES AGAINST FAMILY AND CHILDREN 1 INVOLVING CHILDREN,0,0,0,0
1,Central,PROSTITUTION,0,0,0,0
1,Central,ROBBERY (INDEX),25,0,0,25
1,Central,SEX OFFENSE - CRIMINAL SEXUAL ABUSE,0,0,0,0
1,Central,SIMPLE ASSAULT,0,4,0,4
1,Central,SIMPLE BATTERY,0,52,0,52
1,Central,TRAFFIC VIOLATIONS,1,0,3,4
1,Central,VANDALISM,1,10,4,15
1,Central,WARRANT ARRESTS,0,0,12,12
1,Central,WEAPONS,5,0,1,6
2,Wentworth,AGGRAVATED ASSAULT (INDEX),0,18,0,18
2,Wentworth,AGGRAVATED BATTERY (INDEX),15,0,0,15
2,Wentworth,ARSON (INDEX),0,0,0,0
2,Wentworth,BURGLARY (INDEX),30,0,0,30
2,Wentworth,CRIMINAL SEXUAL ASSAULT (INDEX),8,0,0,8
2,Wentworth,DISORDERLY CONDUCT,4,99,11,114
2,Wentworth,DRIVING UNDER THE INFLUENCE,0,0,0,0
2,Wentworth,DRUG ABUSE VIOLATIONS,9,77,0,86
2,Wentworth,FORGERY AND COUNTERFEITING,2,0,0,2
2,Wentworth,FRAUD,0,0,0,0
2,Wentworth,GAMBLING,0,2,0,2
2,Wentworth,HOMICIDE - 1ST OR 2ND DEGREE (INDEX),3,0,0,3
2,Wentworth,INVOLUNTARY MANSLAUGHTER 1 RECKLESS HOMICIDE W1 VEHICLE,0,0,0,0
2,Wentworth,LARCENY - THEFT (INDEX),24,64,1,89
2,Wentworth,LIQUOR LAWS,0,0,1,1
2,Wentworth,MISCELLANEOUS MUNICIPAL CODE VIOLATIONS,0,0,8,8
2,Wentworth,MISCELLANEOUS NON-INDEX OFFENSES,3,152,4,159
2,Wentworth,MOTOR VEHICLE THEFT (INDEX),22,11,0,33
2,Wentworth,OFFENSES AGAINST FAMILY AND CHILDREN 1 INVOLVING CHILDREN,0,0,0,0
2,Wentworth,PROSTITUTION,0,0,0,0
2,Wentworth,ROBBERY (INDEX),72,0,0,72
2,Wentworth,SEX OFFENSE - CRIMINAL SEXUAL ABUSE,1,2,0,3
2,Wentworth,SIMPLE ASSAULT,0,24,1,25
2,Wentworth,SIMPLE BATTERY,0,114,0,114
2,Wentworth,TRAFFIC VIOLATIONS,0,1,1,2
2,Wentworth,VANDALISM,1,13,0,14
2,Wentworth,WARRANT ARRESTS,0,0,50,50
2,Wentworth,WEAPONS,30,2,14,46
3,Grand Crossing,AGGRAVATED ASSAULT (INDEX),3,29,0,32
3,Grand Crossing,AGGRAVATED BATTERY (INDEX),24,0,0,24
3,Grand Crossing,ARSON (INDEX),2,0,0,2
3,Grand Crossing,BURGLARY (INDEX),52,0,0,52
3,Grand Crossing,CRIMINAL SEXUAL ASSAULT (INDEX),0,0,0,0
3,Grand Crossing,DISORDERLY CONDUCT,2,87,18,107
3,Grand Crossing,DRIVING UNDER THE INFLUENCE,0,0,0,0
3,Grand Crossing,DRUG ABUSE VIOLATIONS,14,61,3,78
3,Grand Crossing,FORGERY AND COUNTERFEITING,0,0,0,0
3,Grand Crossing,FRAUD,0,0,0,0
3,Grand Crossing,GAMBLING,0,17,2,19
3,Grand Crossing,HOMICIDE - 1ST OR 2ND DEGREE (INDEX),2,0,0,2
3,Grand Crossing,LARCENY - THEFT (INDEX),10,26,0,36
3,Grand Crossing,LIQUOR LAWS,0,1,0,1
3,Grand Crossing,MISCELLANEOUS MUNICIPAL CODE VIOLATIONS,0,0,9,9
3,Grand Crossing,MISCELLANEOUS NON-INDEX OFFENSES,1,239,4,244
3,Grand Crossing,MOTOR VEHICLE THEFT (INDEX),28,13,0,41
3,Grand Crossing,OFFENSES AGAINST FAMILY AND CHILDREN 1 INVOLVING CHILDREN,0,0,0,0
3,Grand Crossing,PROSTITUTION,0,0,0,0
3,Grand Crossing,ROBBERY (INDEX),54,0,0,54
3,Grand Crossing,SEX OFFENSE - CRIMINAL SEXUAL ABUSE,3,0,0,3
3,Grand Crossing,SIMPLE ASSAULT,0,29,0,29
3,Grand Crossing,SIMPLE BATTERY,0,107,0,107
3,Grand Crossing,TRAFFIC VIOLATIONS,0,1,1,2
3,Grand Crossing,VANDALISM,2,7,0,9
3,Grand Crossing,WARRANT ARRESTS,0,0,112,112
3,Grand Crossing,WEAPONS,40,3,7,50
4,South Chicago,AGGRAVATED ASSAULT (INDEX),2,21,0,23
4,South Chicago,AGGRAVATED BATTERY (INDEX),26,0,0,26
4,South Chicago,ARSON (INDEX),1,0,0,1
4,South Chicago,BURGLARY (INDEX),34,0,0,34
4,South Chicago,CRIMINAL SEXUAL ASSAULT (INDEX),3,0,0,3
4,South Chicago,DISORDERLY CONDUCT,0,199,36,235
4,South Chicago,DRIVING UNDER THE INFLUENCE,0,0,0,0
4,South Chicago,DRUG ABUSE VIOLATIONS,26,189,1,216
4,South Chicago,FORGERY AND COUNTERFEITING,0,0,0,0
4,South Chicago,FRAUD,1,0,0,1
4,South Chicago,GAMBLING,0,19,0,19
4,South Chicago,HOMICIDE - 1ST OR 2ND DEGREE (INDEX),3,0,0,3
4,South Chicago,LARCENY - THEFT (INDEX),2,51,4,57
4,South Chicago,LIQUOR LAWS,0,5,0,5
4,South Chicago,MISCELLANEOUS MUNICIPAL CODE VIOLATIONS,0,0,8,8
4,South Chicago,MISCELLANEOUS NON-INDEX OFFENSES,7,206,1,214
4,South Chicago,MOTOR VEHICLE THEFT (INDEX),22,7,0,29
4,South Chicago,OFFENSES AGAINST FAMILY AND CHILDREN 1 INVOLVING CHILDREN,0,0,0,0
4,South Chicago,PROSTITUTION,0,0,0,0
4,South Chicago,ROBBERY (INDEX),47,0,0,47
4,South Chicago,SEX OFFENSE - CRIMINAL SEXUAL ABUSE,0,0,1,1
4,South Chicago,SIMPLE ASSAULT,0,30,2,32
4,South Chicago,SIMPLE BATTERY,0,153,0,153
4,South Chicago,"STOLEN PROPERTY: BUY,RECEIVE,POSSESS",0,0,0,0
4,South Chicago,TRAFFIC VIOLATIONS,1,0,3,4
4,South Chicago,VANDALISM,16,23,1,40
4,South Chicago,WARRANT ARRESTS,0,0,95,95
4,South Chicago,WEAPONS,50,12,26,88
5,Calumet,AGGRAVATED ASSAULT (INDEX),1,31,0,32
5,Calumet,AGGRAVATED BATTERY (INDEX),45,0,0,45
5,Calumet,ARSON (INDEX),0,0,0,0
5,Calumet,BURGLARY (INDEX),48,0,0,48
5,Calumet,CRIMINAL SEXUAL ASSAULT (INDEX),3,0,0,3
5,Calumet,DISORDERLY CONDUCT,1,110,70,181
5,Calumet,DRIVING UNDER THE INFLUENCE,0,0,0,0
5,Calumet,DRUG ABUSE VIOLATIONS,13,97,0,110
5,Calumet,FORGERY AND COUNTERFEITING,0,0,0,0
5,Calumet,FRAUD,0,0,0,0
5,Calumet,GAMBLING,0,8,2,10
5,Calumet,HOMICIDE - 1ST OR 2ND DEGREE (INDEX),7,0,0,7
5,Calumet,LARCENY - THEFT (INDEX),11,49,0,60
5,Calumet,LIQUOR LAWS,0,0,1,1
5,Calumet,MISCELLANEOUS MUNICIPAL CODE VIOLATIONS,0,0,10,10
5,Calumet,MISCELLANEOUS NON-INDEX OFFENSES,0,70,3,73
5,Calumet,MOTOR VEHICLE THEFT (INDEX),11,7,0,18
5,Calumet,OFFENSES AGAINST FAMILY AND CHILDREN 1 INVOLVING CHILDREN,0,0,0,0
5,Calumet,PROSTITUTION,0,0,0,0
5,Calumet,ROBBERY (INDEX),62,0,0,62
5,Calumet,SEX OFFENSE - CRIMINAL SEXUAL ABUSE,1,0,0,1
5,Calumet,SIMPLE ASSAULT,0,41,6,47
5,Calumet,SIMPLE BATTERY,0,170,0,170
5,Calumet,TRAFFIC VIOLATIONS,0,0,4,4
5,Calumet,VANDALISM,3,18,0,21
5,Calumet,WARRANT ARRESTS,0,0,90,90
5,Calumet,WEAPONS,58,4,10,72
6,Gresham,AGGRAVATED ASSAULT (INDEX),4,32,0,36
6,Gresham,AGGRAVATED BATTERY (INDEX),31,0,0,31
6,Gresham,ARSON (INDEX),1,0,0,1
6,Gresham,BURGLARY (INDEX),45,0,0,45
6,Gresham,CRIMINAL SEXUAL ASSAULT (INDEX),3,0,0,3
6,Gresham,DISORDERLY CONDUCT,0,127,24,151
6,Gresham,DRIVING UNDER THE INFLUENCE,0,0,0,0
6,Gresham,DRUG ABUSE VIOLATIONS,17,63,1,81
6,Gresham,FORGERY AND COUNTERFEITING,0,0,0,0
6,Gresham,FRAUD,0,0,0,0
6,Gresham,GAMBLING,0,9,0,9
6,Gresham,HOMICIDE - 1ST OR 2ND DEGREE (INDEX),3,0,0,3
6,Gresham,LARCENY - THEFT (INDEX),9,84,1,94
6,Gresham,LIQUOR LAWS,0,1,0,1
6,Gresham,MISCELLANEOUS MUNICIPAL CODE VIOLATIONS,0,0,1,1
6,Gresham,MISCELLANEOUS NON-INDEX OFFENSES,0,102,1,103
6,Gresham,MOTOR VEHICLE THEFT (INDEX),22,9,0,31
6,Gresham,OFFENSES AGAINST FAMILY AND CHILDREN 1 INVOLVING CHILDREN,1,0,1,2
6,Gresham,PROSTITUTION,0,0,0,0
6,Gresham,ROBBERY (INDEX),89,0,0,89
6,Gresham,SEX OFFENSE - CRIMINAL SEXUAL ABUSE,0,0,0,0
6,Gresham,SIMPLE ASSAULT,0,29,0,29
6,Gresham,SIMPLE BATTERY,0,128,0,128
6,Gresham,TRAFFIC VIOLATIONS,0,1,6,7
6,Gresham,VANDALISM,10,20,1,31
6,Gresham,WARRANT ARRESTS,0,0,91,91
6,Gresham,WEAPONS,46,7,6,59
7,Englewood,AGGRAVATED ASSAULT (INDEX),2,28,0,30
7,Englewood,AGGRAVATED BATTERY (INDEX),26,0,0,26
7,Englewood,BURGLARY (INDEX),40,0,0,40
7,Englewood,CRIMINAL SEXUAL ASSAULT (INDEX),4,0,0,4
7,Englewood,DISORDERLY CONDUCT,2,73,6,81
7,Englewood,DRIVING UNDER THE INFLUENCE,0,0,0,0
7,Englewood,DRUG ABUSE VIOLATIONS,27,46,0,73
7,Englewood,FORGERY AND COUNTERFEITING,1,0,0,1
7,Englewood,FRAUD,0,0,0,0
7,Englewood,GAMBLING,0,11,0,11
7,Englewood,HOMICIDE - 1ST OR 2ND DEGREE (INDEX),4,0,0,4
7,Englewood,INVOLUNTARY MANSLAUGHTER 1 RECKLESS HOMICIDE W1 VEHICLE,0,0,0,0
7,Englewood,LARCENY - THEFT (INDEX),9,56,0,65
7,Englewood,LIQUOR LAWS,0,3,0,3
7,Englewood,MISCELLANEOUS MUNICIPAL CODE VIOLATIONS,0,0,6,6
7,Englewood,MISCELLANEOUS NON-INDEX OFFENSES,2,141,3,146
7,Englewood,MOTOR VEHICLE THEFT (INDEX),42,24,0,66
7,Englewood,OFFENSES AGAINST FAMILY AND CHILDREN 1 INVOLVING CHILDREN,0,0,0,0
7,Englewood,PROSTITUTION,0,0,0,0
7,Englewood,ROBBERY (INDEX),99,0,0,99
7,Englewood,SEX OFFENSE - CRIMINAL SEXUAL ABUSE,0,0,1,1
7,Englewood,SIMPLE ASSAULT,0,13,1,14
7,Englewood,SIMPLE BATTERY,0,99,0,99
7,Englewood,TRAFFIC VIOLATIONS,1,3,5,9
7,Englewood,VANDALISM,7,13,0,20
7,Englewood,WARRANT ARRESTS,0,0,130,130
7,Englewood,WEAPONS,51,10,8,69
8,Chicago Lawn,AGGRAVATED ASSAULT (INDEX),1,17,0,18
8,Chicago Lawn,AGGRAVATED BATTERY (INDEX),21,0,0,21
8,Chicago Lawn,ARSON (INDEX),2,0,0,2
8,Chicago Lawn,BURGLARY (INDEX),60,0,0,60
8,Chicago Lawn,CRIMINAL SEXUAL ASSAULT (INDEX),5,0,0,5
8,Chicago Lawn,DISORDERLY CONDUCT,2,270,93,365
8,Chicago Lawn,DRIVING UNDER THE INFLUENCE,0,0,0,0
8,Chicago Lawn,DRUG ABUSE VIOLATIONS,23,142,1,166
8,Chicago Lawn,FORGERY AND COUNTERFEITING,0,0,0,0
8,Chicago Lawn,FRAUD,1,0,0,1
8,Chicago Lawn,GAMBLING,0,18,0,18
8,Chicago Lawn,HOMICIDE - 1ST OR 2ND DEGREE (INDEX),1,0,0,1
8,Chicago Lawn,LARCENY - THEFT (INDEX),20,207,3,230
8,Chicago Lawn,LIQUOR LAWS,0,4,0,4
8,Chicago Lawn,MISCELLANEOUS MUNICIPAL CODE VIOLATIONS,0,0,17,17
8,Chicago Lawn,MISCELLANEOUS NON-INDEX OFFENSES,3,150,2,155
8,Chicago Lawn,MOTOR VEHICLE THEFT (INDEX),19,15,0,34
8,Chicago Lawn,OFFENSES AGAINST FAMILY AND CHILDREN 1 INVOLVING CHILDREN,0,1,0,1
8,Chicago Lawn,PROSTITUTION,0,0,0,0
8,Chicago Lawn,ROBBERY (INDEX),83,0,0,83
8,Chicago Lawn,SEX OFFENSE - CRIMINAL SEXUAL ABUSE,1,1,0,2
8,Chicago Lawn,SIMPLE ASSAULT,2,44,2,48
8,Chicago Lawn,SIMPLE BATTERY,0,115,0,115
8,Chicago Lawn,TRAFFIC VIOLATIONS,0,2,6,8
8,Chicago Lawn,VANDALISM,15,83,20,118
8,Chicago Lawn,WARRANT ARRESTS,0,0,69,69
8,Chicago Lawn,WEAPONS,21,15,21,57
9,Deering,AGGRAVATED ASSAULT (INDEX),4,17,0,21
9,Deering,AGGRAVATED BATTERY (INDEX),35,0,0,35
9,Deering,ARSON (INDEX),0,0,0,0
9,Deering,BURGLARY (INDEX),45,0,0,45
9,Deering,CRIMINAL SEXUAL ASSAULT (INDEX),1,0,0,1
9,Deering,DISORDERLY CONDUCT,0,71,9,80
9,Deering,DRIVING UNDER THE INFLUENCE,0,0,0,0
9,Deering,DRUG ABUSE VIOLATIONS,25,108,0,133
9,Deering,FORGERY AND COUNTERFEITING,1,0,0,1
9,Deering,FRAUD,1,0,0,1
9,Deering,GAMBLING,0,1,0,1
9,Deering,HOMICIDE - 1ST OR 2ND DEGREE (INDEX),4,0,0,4
9,Deering,INVOLUNTARY MANSLAUGHTER 1 RECKLESS HOMICIDE W1 VEHICLE,0,0,0,0
9,Deering,LARCENY - THEFT (INDEX),8,57,0,65
9,Deering,LIQUOR LAWS,0,5,0,5
9,Deering,MISCELLANEOUS MUNICIPAL CODE VIOLATIONS,0,0,7,7
9,Deering,MISCELLANEOUS NON-INDEX OFFENSES,6,112,1,119
9,Deering,MOTOR VEHICLE THEFT (INDEX),26,20,0,46
9,Deering,OFFENSES AGAINST FAMILY AND CHILDREN 1 INVOLVING CHILDREN,0,0,0,0
9,Deering,PROSTITUTION,0,0,0,0
9,Deering,ROBBERY (INDEX),54,0,0,54
9,Deering,SEX OFFENSE - CRIMINAL SEXUAL ABUSE,2,2,0,4
9,Deering,SIMPLE ASSAULT,0,27,0,27
9,Deering,SIMPLE BATTERY,0,95,0,95
9,Deering,TRAFFIC VIOLATIONS,0,0,1,1
9,Deering,VANDALISM,5,42,23,70
9,Deering,WARRANT ARRESTS,0,0,64,64
9,Deering,WEAPONS,29,15,3,47
10,Ogden,AGGRAVATED ASSAULT (INDEX),2,24,0,26
10,Ogden,AGGRAVATED BATTERY (INDEX),26,0,0,26
10,Ogden,ARSON (INDEX),0,0,0,0
10,Ogden,BURGLARY (INDEX),38,0,0,38
10,Ogden,CRIMINAL SEXUAL ASSAULT (INDEX),0,0,0,0
10,Ogden,DISORDERLY CONDUCT,1,135,15,151
10,Ogden,DRIVING UNDER THE INFLUENCE,0,0,0,0
10,Ogden,DRUG ABUSE VIOLATIONS,78,130,1,209
10,Ogden,FORGERY AND COUNTERFEITING,0,0,0,0
10,Ogden,FRAUD,0,0,0,0
10,Ogden,GAMBLING,0,20,7,27
10,Ogden,HOMICIDE - 1ST OR 2ND DEGREE (INDEX),5,0,0,5
10,Ogden,LARCENY - THEFT (INDEX),5,40,0,45
10,Ogden,LIQUOR LAWS,0,7,1,8
10,Ogden,MISCELLANEOUS MUNICIPAL CODE VIOLATIONS,0,0,80,80
10,Ogden,MISCELLANEOUS NON-INDEX OFFENSES,2,93,11,106
10,Ogden,MOTOR VEHICLE THEFT (INDEX),25,14,0,39
10,Ogden,OFFENSES AGAINST FAMILY AND CHILDREN 1 INVOLVING CHILDREN,0,0,0,0
10,Ogden,PROSTITUTION,0,0,0,0
10,Ogden,ROBBERY (INDEX),43,0,0,43
10,Ogden,SEX OFFENSE - CRIMINAL SEXUAL ABUSE,2,1,0,3
10,Ogden,SIMPLE ASSAULT,1,21,0,22
10,Ogden,SIMPLE BATTERY,0,80,0,80
10,Ogden,TRAFFIC VIOLATIONS,0,0,9,9
10,Ogden,VANDALISM,1,37,8,46
10,Ogden,WARRANT ARRESTS,0,0,96,96
10,Ogden,WEAPONS,19,5,10,34
11,Harrison,AGGRAVATED ASSAULT (INDEX),6,19,0,25
11,Harrison,AGGRAVATED BATTERY (INDEX),25,0,0,25
11,Harrison,ARSON (INDEX),0,0,0,0
11,Harrison,BURGLARY (INDEX),17,0,0,17
11,Harrison,CRIMINAL SEXUAL ASSAULT (INDEX),2,0,0,2
11,Harrison,DISORDERLY CONDUCT,0,94,13,107
11,Harrison,DRIVING UNDER THE INFLUENCE,0,0,0,0
11,Harrison,DRUG ABUSE VIOLATIONS,652,150,0,802
11,Harrison,FORGERY AND COUNTERFEITING,0,0,0,0
11,Harrison,FRAUD,1,0,0,1
11,Harrison,GAMBLING,0,15,4,19
11,Harrison,HOMICIDE - 1ST OR 2ND DEGREE (INDEX),0,0,0,0
11,Harrison,INVOLUNTARY MANSLAUGHTER 1 RECKLESS HOMICIDE W1 VEHICLE,0,0,0,0
11,Harrison,LARCENY - THEFT (INDEX),8,52,0,60
11,Harrison,LIQUOR LAWS,0,1,0,1
11,Harrison,MISCELLANEOUS MUNICIPAL CODE VIOLATIONS,0,0,69,69
11,Harrison,MISCELLANEOUS NON-INDEX OFFENSES,3,99,11,113
11,Harrison,MOTOR VEHICLE THEFT (INDEX),57,34,0,91
11,Harrison,OFFENSES AGAINST FAMILY AND CHILDREN 1 INVOLVING CHILDREN,0,0,0,0
11,Harrison,PROSTITUTION,0,1,0,1
11,Harrison,ROBBERY (INDEX),45,0,0,45
11,Harrison,SEX OFFENSE - CRIMINAL SEXUAL ABUSE,1,0,0,1
11,Harrison,SIMPLE ASSAULT,0,14,2,16
11,Harrison,SIMPLE BATTERY,0,131,0,131
11,Harrison,TRAFFIC VIOLATIONS,0,3,3,6
11,Harrison,VANDALISM,5,13,0,18
11,Harrison,WARRANT ARRESTS,0,0,184,184
11,Harrison,WEAPONS,15,7,9,31
12,Near West,AGGRAVATED ASSAULT (INDEX),0,7,0,7
12,Near West,AGGRAVATED BATTERY (INDEX),28,0,0,28
12,Near West,ARSON (INDEX),0,0,0,0
12,Near West,BURGLARY (INDEX),13,0,0,13
12,Near West,CRIMINAL SEXUAL ASSAULT (INDEX),1,0,0,1
12,Near West,DISORDERLY CONDUCT,0,46,7,53
12,Near West,DRIVING UNDER THE INFLUENCE,0,1,0,1
12,Near West,DRUG ABUSE VIOLATIONS,10,57,0,67
12,Near West,FORGERY AND COUNTERFEITING,0,0,0,0
12,Near West,FRAUD,0,0,0,0
12,Near West,GAMBLING,0,2,0,2
12,Near West,HOMICIDE - 1ST OR 2ND DEGREE (INDEX),1,0,0,1
12,Near West,LARCENY - THEFT (INDEX),7,28,0,35
12,Near West,LIQUOR LAWS,0,7,1,8
12,Near West,MISCELLANEOUS MUNICIPAL CODE VIOLATIONS,0,0,8,8
12,Near West,MISCELLANEOUS NON-INDEX OFFENSES,3,59,0,62
12,Near West,MOTOR VEHICLE THEFT (INDEX),16,0,0,16
12,Near West,OFFENSES AGAINST FAMILY AND CHILDREN 1 INVOLVING CHILDREN,0,0,0,0
12,Near West,PROSTITUTION,0,0,0,0
12,Near West,ROBBERY (INDEX),47,0,0,47
12,Near West,SEX OFFENSE - CRIMINAL SEXUAL ABUSE,1,1,2,4
12,Near West,SIMPLE ASSAULT,0,18,0,18
12,Near West,SIMPLE BATTERY,0,62,0,62
12,Near West,"STOLEN PROPERTY: BUY,RECEIVE,POSSESS",0,0,0,0
12,Near West,TRAFFIC VIOLATIONS,0,0,4,4
12,Near West,VANDALISM,5,21,2,28
12,Near West,WARRANT ARRESTS,0,0,27,27
12,Near West,WEAPONS,11,7,5,23
14,Shakespeare,AGGRAVATED ASSAULT (INDEX),0,2,0,2
14,Shakespeare,AGGRAVATED BATTERY (INDEX),1,0,0,1
14,Shakespeare,ARSON (INDEX),0,0,0,0
14,Shakespeare,BURGLARY (INDEX),9,0,0,9
14,Shakespeare,CRIMINAL SEXUAL ASSAULT (INDEX),0,0,0,0
14,Shakespeare,DISORDERLY CONDUCT,0,20,1,21
14,Shakespeare,DRIVING UNDER THE INFLUENCE,0,0,0,0
14,Shakespeare,DRUG ABUSE VIOLATIONS,8,46,1,55
14,Shakespeare,FORGERY AND COUNTERFEITING,0,0,0,0
14,Shakespeare,FRAUD,0,0,0,0
14,Shakespeare,HOMICIDE - 1ST OR 2ND DEGREE (INDEX),1,0,0,1
14,Shakespeare,LARCENY - THEFT (INDEX),6,24,0,30
14,Shakespeare,LIQUOR LAWS,0,6,1,7
14,Shakespeare,MISCELLANEOUS MUNICIPAL CODE VIOLATIONS,0,0,8,8
14,Shakespeare,MISCELLANEOUS NON-INDEX OFFENSES,0,57,0,57
14,Shakespeare,MOTOR VEHICLE THEFT (INDEX),1,1,0,2
14,Shakespeare,OFFENSES AGAINST FAMILY AND CHILDREN 1 INVOLVING CHILDREN,0,0,1,1
14,Shakespeare,PROSTITUTION,0,0,0,0
14,Shakespeare,ROBBERY (INDEX),18,0,0,18
14,Shakespeare,SEX OFFENSE - CRIMINAL SEXUAL ABUSE,1,0,0,1
14,Shakespeare,SIMPLE ASSAULT,0,7,0,7
14,Shakespeare,SIMPLE BATTERY,0,21,0,21
14,Shakespeare,"STOLEN PROPERTY: BUY,RECEIVE,POSSESS",0,0,0,0
14,Shakespeare,TRAFFIC VIOLATIONS,0,0,7,7
14,Shakespeare,VANDALISM,4,15,1,20
14,Shakespeare,WARRANT ARRESTS,0,0,22,22
14,Shakespeare,WEAPONS,3,2,3,8
15,Austin,AGGRAVATED ASSAULT (INDEX),1,19,0,20
15,Austin,AGGRAVATED BATTERY (INDEX),33,0,0,33
15,Austin,ARSON (INDEX),0,0,0,0
15,Austin,BURGLARY (INDEX),33,0,0,33
15,Austin,CRIMINAL SEXUAL ASSAULT (INDEX),2,0,0,2
15,Austin,DISORDERLY CONDUCT,1,80,20,101
15,Austin,DRIVING UNDER THE INFLUENCE,1,0,0,1
15,Austin,DRUG ABUSE VIOLATIONS,96,276,0,372
15,Austin,FORGERY AND COUNTERFEITING,0,0,0,0
15,Austin,FRAUD,0,0,0,0
15,Austin,GAMBLING,0,52,0,52
15,Austin,HOMICIDE - 1ST OR 2ND DEGREE (INDEX),2,0,0,2
15,Austin,LARCENY - THEFT (INDEX),10,19,0,29
15,Austin,LIQUOR LAWS,0,0,1,1
15,Austin,MISCELLANEOUS MUNICIPAL CODE VIOLATIONS,0,0,111,111
15,Austin,MISCELLANEOUS NON-INDEX OFFENSES,1,182,34,217
15,Austin,MOTOR VEHICLE THEFT (INDEX),31,17,0,48
15,Austin,OFFENSES AGAINST FAMILY AND CHILDREN 1 INVOLVING CHILDREN,0,0,0,0
15,Austin,PROSTITUTION,0,0,0,0
15,Austin,ROBBERY (INDEX),62,0,0,62
15,Austin,SEX OFFENSE - CRIMINAL SEXUAL ABUSE,0,0,0,0
15,Austin,SIMPLE ASSAULT,0,12,0,12
15,Austin,SIMPLE BATTERY,0,86,0,86
15,Austin,TRAFFIC VIOLATIONS,0,2,13,15
15,Austin,VANDALISM,6,20,0,26
15,Austin,WARRANT ARRESTS,0,0,94,94
15,Austin,WEAPONS,16,6,9,31
16,Jefferson Park,AGGRAVATED ASSAULT (INDEX),1,10,0,11
16,Jefferson Park,AGGRAVATED BATTERY (INDEX),12,0,0,12
16,Jefferson Park,ARSON (INDEX),1,0,0,1
16,Jefferson Park,BURGLARY (INDEX),18,0,0,18
16,Jefferson Park,CRIMINAL SEXUAL ASSAULT (INDEX),0,0,0,0
16,Jefferson Park,DISORDERLY CONDUCT,0,39,1,40
16,Jefferson Park,DRIVING UNDER THE INFLUENCE,0,0,0,0
16,Jefferson Park,DRUG ABUSE VIOLATIONS,3,69,1,73
16,Jefferson Park,FORGERY AND COUNTERFEITING,0,1,0,1
16,Jefferson Park,FRAUD,1,0,0,1
16,Jefferson Park,HOMICIDE - 1ST OR 2ND DEGREE (INDEX),0,0,0,0
16,Jefferson Park,LARCENY - THEFT (INDEX),6,23,0,29
16,Jefferson Park,LIQUOR LAWS,0,2,0,2
16,Jefferson Park,MISCELLANEOUS MUNICIPAL CODE VIOLATIONS,0,0,0,0
16,Jefferson Park,MISCELLANEOUS NON-INDEX OFFENSES,1,35,1,37
16,Jefferson Park,MOTOR VEHICLE THEFT (INDEX),2,2,0,4
16,Jefferson Park,OFFENSES AGAINST FAMILY AND CHILDREN 1 INVOLVING CHILDREN,0,0,0,0
16,Jefferson Park,PROSTITUTION,0,0,0,0
16,Jefferson Park,ROBBERY (INDEX),14,0,0,14
16,Jefferson Park,SEX OFFENSE - CRIMINAL SEXUAL ABUSE,0,1,0,1
16,Jefferson Park,SIMPLE ASSAULT,0,10,1,11
16,Jefferson Park,SIMPLE BATTERY,0,51,0,51
16,Jefferson Park,"STOLEN PROPERTY: BUY,RECEIVE,POSSESS",0,0,0,0
16,Jefferson Park,TRAFFIC VIOLATIONS,0,0,1,1
16,Jefferson Park,VANDALISM,4,14,2,20
16,Jefferson Park,WARRANT ARRESTS,0,0,20,20
16,Jefferson Park,WEAPONS,2,5,1,8
17,Albany Park,AGGRAVATED ASSAULT (INDEX),1,13,0,14
17,Albany Park,AGGRAVATED BATTERY (INDEX),20,0,0,20
17,Albany Park,BURGLARY (INDEX),12,0,0,12
17,Albany Park,CRIMINAL SEXUAL ASSAULT (INDEX),1,0,0,1
17,Albany Park,DISORDERLY CONDUCT,0,54,1,55
17,Albany Park,DRIVING UNDER THE INFLUENCE,0,1,0,1
17,Albany Park,DRUG ABUSE VIOLATIONS,10,75,0,85
17,Albany Park,FORGERY AND COUNTERFEITING,0,0,0,0
17,Albany Park,FRAUD,0,0,0,0
17,Albany Park,GAMBLING,0,0,0,0
17,Albany Park,HOMICIDE - 1ST OR 2ND DEGREE (INDEX),0,0,0,0
17,Albany Park,LARCENY - THEFT (INDEX),12,67,0,79
17,Albany Park,LIQUOR LAWS,0,1,0,1
17,Albany Park,MISCELLANEOUS MUNICIPAL CODE VIOLATIONS,0,0,6,6
17,Albany Park,MISCELLANEOUS NON-INDEX OFFENSES,0,34,0,34
17,Albany Park,MOTOR VEHICLE THEFT (INDEX),4,5,0,9
17,Albany Park,OFFENSES AGAINST FAMILY AND CHILDREN 1 INVOLVING CHILDREN,0,0,0,0
17,Albany Park,PROSTITUTION,0,0,0,0
17,Albany Park,ROBBERY (INDEX),16,0,0,16
17,Albany Park,SEX OFFENSE - CRIMINAL SEXUAL ABUSE,0,0,0,0
17,Albany Park,SIMPLE ASSAULT,0,8,0,8
17,Albany Park,SIMPLE BATTERY,0,51,0,51
17,Albany Park,TRAFFIC VIOLATIONS,0,0,2,2
17,Albany Park,VANDALISM,4,25,4,33
17,Albany Park,WARRANT ARRESTS,0,0,21,21
17,Albany Park,WEAPONS,5,5,2,12
18,Near North,AGGRAVATED ASSAULT (INDEX),0,1,0,1
18,Near North,AGGRAVATED BATTERY (INDEX),5,0,0,5
18,Near North,ARSON (INDEX),0,0,0,0
18,Near North,BURGLARY (INDEX),10,0,0,10
18,Near North,CRIMINAL SEXUAL ASSAULT (INDEX),2,0,0,2
18,Near North,DISORDERLY CONDUCT,0,22,0,22
18,Near North,DRIVING UNDER THE INFLUENCE,0,1,0,1
18,Near North,DRUG ABUSE VIOLATIONS,9,8,0,17
18,Near North,FORGERY AND COUNTERFEITING,0,0,0,0
18,Near North,FRAUD,0,0,0,0
18,Near North,HOMICIDE - 1ST OR 2ND DEGREE (INDEX),1,0,0,1
18,Near North,LARCENY - THEFT (INDEX),46,188,1,235
18,Near North,LIQUOR LAWS,0,1,0,1
18,Near North,MISCELLANEOUS MUNICIPAL CODE VIOLATIONS,0,0,4,4
18,Near North,MISCELLANEOUS NON-INDEX OFFENSES,2,49,3,54
18,Near North,MOTOR VEHICLE THEFT (INDEX),0,0,0,0
18,Near North,OFFENSES AGAINST FAMILY AND CHILDREN 1 INVOLVING CHILDREN,0,0,0,0
18,Near North,PROSTITUTION,0,0,0,0
18,Near North,ROBBERY (INDEX),18,0,0,18
18,Near North,SEX OFFENSE - CRIMINAL SEXUAL ABUSE,3,0,0,3
18,Near North,SIMPLE ASSAULT,0,9,0,9
18,Near North,SIMPLE BATTERY,0,20,0,20
18,Near North,TRAFFIC VIOLATIONS,0,0,0,0
18,Near North,VANDALISM,0,6,0,6
18,Near North,WARRANT ARRESTS,0,0,14,14
18,Near North,WEAPONS,3,2,2,7
19,Town Hall,AGGRAVATED ASSAULT (INDEX),0,2,0,2
19,Town Hall,AGGRAVATED BATTERY (INDEX),12,0,0,12
19,Town Hall,BURGLARY (INDEX),10,0,0,10
19,Town Hall,CRIMINAL SEXUAL ASSAULT (INDEX),4,0,0,4
19,Town Hall,DISORDERLY CONDUCT,0,16,7,23
19,Town Hall,DRIVING UNDER THE INFLUENCE,0,0,0,0
19,Town Hall,DRUG ABUSE VIOLATIONS,10,48,1,59
19,Town Hall,FORGERY AND COUNTERFEITING,0,0,0,0
19,Town Hall,FRAUD,0,0,0,0
19,Town Hall,HOMICIDE - 1ST OR 2ND DEGREE (INDEX),3,0,0,3
19,Town Hall,LARCENY - THEFT (INDEX),5,71,0,76
19,Town Hall,LIQUOR LAWS,0,2,1,3
19,Town Hall,MISCELLANEOUS MUNICIPAL CODE VIOLATIONS,0,0,4,4
19,Town Hall,MISCELLANEOUS NON-INDEX OFFENSES,2,28,1,31
19,Town Hall,MOTOR VEHICLE THEFT (INDEX),2,0,0,2
19,Town Hall,OFFENSES AGAINST FAMILY AND CHILDREN 1 INVOLVING CHILDREN,0,0,0,0
19,Town Hall,PROSTITUTION,0,0,0,0
19,Town Hall,ROBBERY (INDEX),22,0,0,22
19,Town Hall,SEX OFFENSE - CRIMINAL SEXUAL ABUSE,1,0,1,2
19,Town Hall,SIMPLE ASSAULT,0,3,0,3
19,Town Hall,SIMPLE BATTERY,0,36,0,36
19,Town Hall,TRAFFIC VIOLATIONS,0,0,0,0
19,Town Hall,VANDALISM,1,12,2,15
19,Town Hall,WARRANT ARRESTS,0,0,11,11
19,Town Hall,WEAPONS,2,2,4,8
20,Lincoln,AGGRAVATED ASSAULT (INDEX),2,8,0,10
20,Lincoln,AGGRAVATED BATTERY (INDEX),2,0,0,2
20,Lincoln,ARSON (INDEX),1,0,0,1
20,Lincoln,BURGLARY (INDEX),5,0,0,5
20,Lincoln,CRIMINAL SEXUAL ASSAULT (INDEX),0,0,0,0
20,Lincoln,DISORDERLY CONDUCT,0,22,3,25
20,Lincoln,DRIVING UNDER THE INFLUENCE,0,0,0,0
20,Lincoln,DRUG ABUSE VIOLATIONS,4,24,1,29
20,Lincoln,FORGERY AND COUNTERFEITING,0,0,0,0
20,Lincoln,FRAUD,1,0,0,1
20,Lincoln,GAMBLING,0,0,0,0
20,Lincoln,HOMICIDE - 1ST OR 2ND DEGREE (INDEX),0,0,0,0
20,Lincoln,INVOLUNTARY MANSLAUGHTER 1 RECKLESS HOMICIDE W1 VEHICLE,0,0,0,0
20,Lincoln,LARCENY - THEFT (INDEX),6,22,0,28
20,Lincoln,LIQUOR LAWS,0,2,0,2
20,Lincoln,MISCELLANEOUS MUNICIPAL CODE VIOLATIONS,0,0,0,0
20,Lincoln,MISCELLANEOUS NON-INDEX OFFENSES,0,13,0,13
20,Lincoln,MOTOR VEHICLE THEFT (INDEX),2,1,0,3
20,Lincoln,OFFENSES AGAINST FAMILY AND CHILDREN 1 INVOLVING CHILDREN,0,0,0,0
20,Lincoln,PROSTITUTION,0,0,0,0
20,Lincoln,ROBBERY (INDEX),3,0,0,3
20,Lincoln,SEX OFFENSE - CRIMINAL SEXUAL ABUSE,0,0,0,0
20,Lincoln,SIMPLE ASSAULT,0,7,0,7
20,Lincoln,SIMPLE BATTERY,0,41,0,41
20,Lincoln,"STOLEN PROPERTY: BUY,RECEIVE,POSSESS",0,0,0,0
20,Lincoln,TRAFFIC VIOLATIONS,0,0,0,0
20,Lincoln,VANDALISM,4,8,0,12
20,Lincoln,WARRANT ARRESTS,0,0,11,11
20,Lincoln,WEAPONS,0,3,2,5
22,Morgan Park,AGGRAVATED ASSAULT (INDEX),1,26,0,27
22,Morgan Park,AGGRAVATED BATTERY (INDEX),28,0,0,28
22,Morgan Park,ARSON (INDEX),0,0,0,0
22,Morgan Park,BURGLARY (INDEX),26,0,0,26
22,Morgan Park,CRIMINAL SEXUAL ASSAULT (INDEX),3,0,0,3
22,Morgan Park,DISORDERLY CONDUCT,7,68,2,77
22,Morgan Park,DRIVING UNDER THE INFLUENCE,0,0,0,0
22,Morgan Park,DRUG ABUSE VIOLATIONS,3,66,0,69
22,Morgan Park,FORGERY AND COUNTERFEITING,0,0,0,0
22,Morgan Park,FRAUD,1,0,0,1
22,Morgan Park,GAMBLING,0,6,0,6
22,Morgan Park,HOMICIDE - 1ST OR 2ND DEGREE (INDEX),1,0,0,1
22,Morgan Park,LARCENY - THEFT (INDEX),10,46,0,56
22,Morgan Park,LIQUOR LAWS,0,0,0,0
22,Morgan Park,MISCELLANEOUS MUNICIPAL CODE VIOLATIONS,0,0,4,4
22,Morgan Park,MISCELLANEOUS NON-INDEX OFFENSES,3,89,1,93
22,Morgan Park,MOTOR VEHICLE THEFT (INDEX),27,4,0,31
22,Morgan Park,OFFENSES AGAINST FAMILY AND CHILDREN 1 INVOLVING CHILDREN,0,0,2,2
22,Morgan Park,PROSTITUTION,0,0,0,0
22,Morgan Park,ROBBERY (INDEX),30,0,0,30
22,Morgan Park,SEX OFFENSE - CRIMINAL SEXUAL ABUSE,0,0,0,0
22,Morgan Park,SIMPLE ASSAULT,0,13,0,13
22,Morgan Park,SIMPLE BATTERY,1,110,0,111
22,Morgan Park,TRAFFIC VIOLATIONS,1,1,4,6
22,Morgan Park,VANDALISM,4,5,0,9
22,Morgan Park,WARRANT ARRESTS,0,0,43,43
22,Morgan Park,WEAPONS,33,5,8,46
24,Rogers Park,AGGRAVATED ASSAULT (INDEX),0,9,0,9
24,Rogers Park,AGGRAVATED BATTERY (INDEX),9,0,0,9
24,Rogers Park,BURGLARY (INDEX),8,0,0,8
24,Rogers Park,CRIMINAL SEXUAL ASSAULT (INDEX),0,0,0,0
24,Rogers Park,DISORDERLY CONDUCT,0,20,16,36
24,Rogers Park,DRIVING UNDER THE INFLUENCE,0,0,0,0
24,Rogers Park,DRUG ABUSE VIOLATIONS,6,32,0,38
24,Rogers Park,FORGERY AND COUNTERFEITING,0,0,0,0
24,Rogers Park,FRAUD,2,0,0,2
24,Rogers Park,HOMICIDE - 1ST OR 2ND DEGREE (INDEX),0,0,0,0
24,Rogers Park,LARCENY - THEFT (INDEX),3,21,0,24
24,Rogers Park,LIQUOR LAWS,0,0,1,1
24,Rogers Park,MISCELLANEOUS MUNICIPAL CODE VIOLATIONS,0,0,1,1
24,Rogers Park,MISCELLANEOUS NON-INDEX OFFENSES,1,64,1,66
24,Rogers Park,MOTOR VEHICLE THEFT (INDEX),3,0,0,3
24,Rogers Park,OFFENSES AGAINST FAMILY AND CHILDREN 1 INVOLVING CHILDREN,0,0,0,0
24,Rogers Park,PROSTITUTION,0,0,0,0
24,Rogers Park,ROBBERY (INDEX),17,0,0,17
24,Rogers Park,SEX OFFENSE - CRIMINAL SEXUAL ABUSE,0,0,0,0
24,Rogers Park,SIMPLE ASSAULT,0,3,0,3
24,Rogers Park,SIMPLE BATTERY,0,38,0,38
24,Rogers Park,"STOLEN PROPERTY: BUY,RECEIVE,POSSESS",0,0,0,0
24,Rogers Park,TRAFFIC VIOLATIONS,0,1,4,5
24,Rogers Park,VANDALISM,0,13,1,14
24,Rogers Park,WARRANT ARRESTS,0,0,37,37
24,Rogers Park,WEAPONS,9,2,3,14
25,Grand Central,AGGRAVATED ASSAULT (INDEX),1,9,0,10
25,Grand Central,AGGRAVATED BATTERY (INDEX),19,0,0,19
25,Grand Central,ARSON (INDEX),0,0,0,0
25,Grand Central,BURGLARY (INDEX),27,0,0,27
25,Grand Central,CRIMINAL SEXUAL ASSAULT (INDEX),1,0,0,1
25,Grand Central,DISORDERLY CONDUCT,0,44,3,47
25,Grand Central,DRIVING UNDER THE INFLUENCE,0,0,0,0
25,Grand Central,DRUG ABUSE VIOLATIONS,20,105,1,126
25,Grand Central,FORGERY AND COUNTERFEITING,0,0,0,0
25,Grand Central,FRAUD,0,0,0,0
25,Grand Central,GAMBLING,0,2,0,2
25,Grand Central,HOMICIDE - 1ST OR 2ND DEGREE (INDEX),0,0,0,0
25,Grand Central,LARCENY - THEFT (INDEX),9,63,0,72
25,Grand Central,LIQUOR LAWS,0,1,0,1
25,Grand Central,MISCELLANEOUS MUNICIPAL CODE VIOLATIONS,0,0,6,6
25,Grand Central,MISCELLANEOUS NON-INDEX OFFENSES,3,95,0,98
25,Grand Central,MOTOR VEHICLE THEFT (INDEX),21,16,0,37
25,Grand Central,OFFENSES AGAINST FAMILY AND CHILDREN 1 INVOLVING CHILDREN,0,0,0,0
25,Grand Central,PROSTITUTION,0,0,2,2
25,Grand Central,ROBBERY (INDEX),32,0,0,32
25,Grand Central,SEX OFFENSE - CRIMINAL SEXUAL ABUSE,1,1,0,2
25,Grand Central,SIMPLE ASSAULT,0,15,1,16
25,Grand Central,SIMPLE BATTERY,0,76,0,76
25,Grand Central,TRAFFIC VIOLATIONS,1,4,8,13
25,Grand Central,VANDALISM,9,23,9,41
25,Grand Central,WARRANT ARRESTS,0,0,55,55
25,Grand Central,WEAPONS,22,3,3,28
